   ██████████████████████████████████████████████████████████
      █              █        █           █           █     █
█  ████  █  █  ████  ████  █  █  ████  ████  ████  ████  ████
█        █  █  █           █  █  █        █  █     █     █  █
███████  ████████████████  █████████████  ████  █  █  ████  █
█              █  █  █  █        █           █  █  █     █  █
█  █████████████  █  █  ███████  ████  ███████  ███████  █  █
█           █  █                    █     █  █  █  █  █  █  █
█  ████  ████  ███████  ██████████  █  █  █  █  █  █  █  █  █
█  █           █     █     █  █  █  █  █  █     █           █
████  █████████████  ███████  █  █  █  ███████  ████  ████  █
█           █        █  █     █  █                    █  █  █
█  ████  ███████  █  █  █  █  █  █  ████  ████  ███████  █  █
█     █        █  █        █           █     █  █  █        █
██████████  ████  █  ████  █████████████  ███████  █  █  ████
█     █        █  █  █           █     █  █           █  █  █
████  ████  █  █████████████  █  █  █  ███████  ████  █  █  █
█  █        █  █        █     █  █  █           █  █  █     █
█  ████  █  ███████  █  █  █  ████  ████  ███████  █  █  ████
█        █  █        █     █  █        █        █     █      
██████████████████████████████████████████████████████████   